EA assets/defaut.xpm
NO assets/default.xpm
SO assets/default.xpm
WE assets/default.xpm

F 0,0,0
C 255,255,255


 11111111111111111111111111111111111111111111111111111111111111111111111111111111111111111111
10E100000000000000000000000000000000000000000000000000000000000000000000000000000000000000001
 11111111111111111111111111111111111111111111111111111111111111111111111111111111111111111111
