NO assets/minecraft/minecraft_n1.xpm
NO assets/minecraft/minecraft_n2.xpm
NO assets/minecraft/minecraft_n3.xpm
NO assets/minecraft/minecraft_n2.xpm
SO assets/minecraft/minecraft_s1.xpm
SO assets/minecraft/minecraft_s2.xpm
SO assets/minecraft/minecraft_s3.xpm
SO assets/minecraft/minecraft_s4.xpm
SO assets/minecraft/minecraft_s5.xpm
SO assets/minecraft/minecraft_s6.xpm
SO assets/minecraft/minecraft_s7.xpm
WE assets/minecraft/minecraft_w1.xpm
WE assets/minecraft/minecraft_w2.xpm
WE assets/minecraft/minecraft_w3.xpm
WE assets/minecraft/minecraft_w2.xpm
EA assets/minecraft/minecraft_e1.xpm
EA assets/minecraft/minecraft_e2.xpm
EA assets/minecraft/minecraft_e3.xpm
EA assets/minecraft/minecraft_e2.xpm

T assets/amelie_poulain/amelie_poulaint_1.xpm
T assets/amelie_poulain/amelie_poulaint_2.xpm
T assets/amelie_poulain/amelie_poulaint_3.xpm
T assets/amelie_poulain/amelie_poulaint_4.xpm
T assets/amelie_poulain/amelie_poulaint_5.xpm
T assets/amelie_poulain/amelie_poulaint_6.xpm
T assets/amelie_poulain/amelie_poulaint_7.xpm
T assets/amelie_poulain/amelie_poulaint_8.xpm
T assets/amelie_poulain/amelie_poulaint_9.xpm
T assets/amelie_poulain/amelie_poulaint_10.xpm
T assets/amelie_poulain/amelie_poulaint_11.xpm
T assets/amelie_poulain/amelie_poulaint_12.xpm
T assets/amelie_poulain/amelie_poulaint_13.xpm
T assets/amelie_poulain/amelie_poulaint_14.xpm


C 32,32,32
F 28,35,19


111
1T1
1N1
101111111111111111
100011100T00000001
10000T000001100001
1011100000000T0001
111111111111111111
