NO assets/door/door_darken.xpm
SO assets/door/door_darken.xpm
WE assets/door/door_darken.xpm
EA assets/door/door_darken.xpm

F 124,99,84
C 150,110,89

D assets/door/door.xpm

11111111111111111111111111111111111
10000000000001000000000000000000001
10001000010001000100010000000000001
10000100000001100000001000010000001
1001W000100000100000010000000000001
10000100000001110000000100000000001
10000001000000D00000000000100100001
10000000110000110001100000000001001
10110000000011100000000000100001001
10100000000010101001001000000000001
10000000000110000000000100000000001
11111111111111111111111111111111111