NO assets/door/door_darken.xpm
SO assets/door/door_darken.xpm
WE assets/door/door_darken.xpm
EA assets/door/door_darken.xpm

F 124,99,84
C 150,110,89

D assets/door/door.xpm

11111
10001
1ED11
11111