EA assets/boat.xpm
NO assets/default.xpm
SO assets/default.xpm
WE assets/default.xpm
EA assets/default.xpm
NO assets/default.xpm
NO assets/default.xpm
NO assets/default.xpm
NO assets/default.xpm
NO assets/default.xpm
EA assets/mouse.xpm
EA assets/sd.xpm
EA assets/car.xpm


F 0,0,0
C 255,255,255


 111111111111111
10E00000000000001
 111111111111111
