NO assets/default.xpm
SO assets/default.xpm
WE assets/default.xpm
EA assets/default.xpm

F 0,0,0
C 255,255,255


 111111111111111
1E000000000000001
 111111111111110