EA assets/whatsapp/whatsapp_e.xpm
NO assets/whatsapp/whatsapp_n.xpm
SO assets/whatsapp/whatsapp_s.xpm
WE assets/whatsapp/whatsapp_w.xpm

F 0,0,0
C 255,255,255


 1111111111111111111111111111111111111111111111111111111111111111111111111111111111111111111
10E100000000000000000000000000000000000000000000000000000000000000000000000000000000000000001
 1111111111111111111111111111111111111111111111111111111111111111111111111111111111111111111
