NO assets/default.xpm
SO assets/default.xpm
EA assets/default.xpm

F 0,0,0
C 300,30,0


 111111111111111
1E000000000000001
 111111111111111