NO assets/default.xpm
SO assets/default.xpm
EA assets/default.xpm

F 220,100,0
C 300,30,0


 111111111111111
1N000000000000001
 111111111111111