NO assets/test.xpm
SO assets/test.xpm
WE assets/test.xpm
EA assets/test.xpm

F 220,100,0
C 225,30,0


 111111111111111
1E000W00000000001
 111111111111111