NO assets/default.xpm
SO assets/default.xpm
WE assets/default.xpm
EA assets/default.xpm

F 220,100,0
C 225,30,0


 111111111111110
1N000000000000001
 111111111111111