NO assets/default.xpm
SO assets/default.xpm
WE assets/default.xpm
EA assets/default.xpm

F 0,0,0
C 255,255,255


         111111   111111   
        1E000001110000001     
         111111111111111    