WE assets/default.xpm
F 220,100,0
NO assets/default.xpm

EA assets/default.xpm
C 225,30,0

SO assets/default.xpm

 111111111111111
1N000000000000001
 111111111111111