NO assets/heart/heart.xpm
SO assets/heart/heart.xpm
WE assets/heart/heart.xpm
EA assets/heart/heart.xpm

C 250,165,208
F 250,165,208


          1111     1111   
         100001   100001   
        1E000001110000001     
         100000000000001                      
          1000000000001   
           10000000001          
            100000001             
             1000001  
              10001  
               101      
                1    