WE assets/default.xpm
F 0,0,0
NO assets/default.xpm

EA assets/default.xpm
C 255,255,255

SO assets/default.xpm

 111111111111111
1W000000000000001
 111111111111111