NO assets/default.xpm
SO assets/default.xpm
WE assets/default.xpm
EA assets/default.xpm

F 255,153,54
C 0,0,0,1


 111111111111111
1W000000000000001
 111111111111111