NO assets/max_payne/max_payne_n.xpm
SO assets/max_payne/max_payne_s.xpm
WE assets/max_payne/max_payne_ew.xpm
EA assets/max_payne/max_payne_ew.xpm

C 34,31,24
F 34,31,24


 111111111111111
1E000000000000001
 111111111111111