NO assets/default.xpm
SO assets/default.xpm
WE assets/default.xpm
EA assets/default.xpm

F 0,0,0
C 300,30,0


 111111111111110
1W000000000000001
 111111111111111